NO  /home/imittous/Desktop/cude-3D/main.c
F 220,100,0





SO /home/imittous/Desktop/cude-3D/main.c



WE /home/imittous/Desktop/cude-3D/main.c
C 225,30,0



EA      main.c
 11111111111111111    <== //had lcase makhdamach 
10000001S0000000001
1000000000000000001
100000000000000001
100001111111100001
10001       1000001
10001       1000001
10001       1000001
1000111111111000001
100000000000000001
100000000000000001
100000000000000001
1000000000000000001
1000000000000000001
100000000000001011
100000000000001111
 1111111111111
