






SO main.c
WE main.c


NO mai n.c
EA main.c
F 2 0, 215, 99
C 20  ,206,219

                                                                                                                1111111111 111111111111111     1111111111111111111111111
                                                                                                                1000000000110000000000001
                                                                                                                1011000001110000000000001
                                                                                                                100100000000000000000000111111111
                                                                                                                111111110011000001110000000000001
                                                                                                                1100000111010101111101111000111          1N11111111111111111    111111111       
                                                                                                                11110111 1110101 101111010001            1111
                                                                                                                11111111 1111111 1111111111111111