111111111111111111 111111
1110000000000000E00000001
11111111000011111101111
1111111100000000000111
111111111111111111111111111111111111