SO ./texturs/wall.xpm
WE ./texturs/wall.xpm
NO ./texturs/wall.xpm
EA ./texturs/wall.xpm
F 36,37,38
C 104,106,119

11111111111111111111111111111111
10011111100111111111111110000001
10001    10000000000000000111111
11011    111111111111001101                           111111
100011111110000000000000001                          10000001
10001000011011111111111111111111111111111           1000000001
1000100001101               1000000000001          100000000001
1000100001101               100000000000111111111110000000000001
100011110110111111          100000000000000000000000000000000001
100011000000000001          100000000000111111111110000000000001
100011000000000001          1000000000001          100000000001
100011000000000001111111111110N0000000001           1000000001
10001100000000000000000000000000011111111            10000001
1000000000000000011111111111111011                    111111
1111111111111111111111111111111111