1111111111111111111111111
11100000000000001
1111E11111111111111111
111111110011111
111111111111111111111111111111111111