SO ./texturs/wall1.xpm
WE ./texturs/wall2.xpm
NO ./texturs/wall3.xpm
EA ./texturs/wall4.xpm

F 36,37,38
C 104,106,119

111111111111111111111111111111111111111111111111111111111111111111
1001111110011111111111111000000000000000000000000000000000000000001
10001    10000000000000000111111111111111111111111111111111111111001
11011    111111111111001101                           111111     1001
100011111110000000000000001                          10000001     1001 
10001000011011111111111111111111111111111           1000000001     1001
1000100001101               1000000000001          100000000001     1001
1000100001101               100000000000111111111110000000000001     1001
100011110110111111          100000000000000000000000000000000001     1001
100011000000000001          100000000000111111111110000001000001     1001
100011000000000001          1000000000001          100000010001     1001
10001100000000000111111111111000000000001           1000000001     1001
10001100000000000000000000000000011111111            10000001     1001
1000000000000000011111111111111011                    111111     1001
111111111111111111111111111111100111                            1001
                               100011111111111111111111111111111001
                                10000000000000000000000000000000001
                                11111111111111111111111111111111111
