SO main.c
WE main.c
NO main.c
EA main.c
F 20,215,99    
C 20,206,219

1111111111 1111111111111111111111111111111111111111
1000000000110000000000001
1011000001110000000000001
100100000000000000000000111111111
1111111100110000011100000000000011
110000011101010111110111100011111N11111111111111111111111111       
11110111 1110101 10111101000111111
11111111 1111111 1111111111111111