


NO    ./texturs/wolfenstein1.xpm                        



EA    ./texturs/wolfenstein2.xpm                        




    WE   ./texturs/wolfenstein3.xpm                          
     SO    ./texturs/wolfenstein4.xpm                        

F 255,218,185                                           

C      240,255,255                        

        111111111111111111111111111111111111111111111
        100000000011000000000000111111111111111111111
        101100000111000000000000111111111111111111111
        100100000000000000000000111111111111111111111
11111111101100000111000000000000111111111111111
1000000000110000011101111111111111111111111111
111111111111111111111111111111111111111111111
111111111111111111111111111111111111111111111
111101111111110111000000100011111111111111
111101111111110111010100100011111111111111   
110000001101010111000000100011111111111111
100000000000000011000000100011111111111111
100000000000000011010100100011111111111111
11000001110101011111011110N01111111111111111
11110111 1110101 1011110100011111111111111
11111111 1111111 11111111111111111111
