


WE    ./texturs/wall1.xpm



NO    ./texturs/wall3.xpm



F 0,0,0


    SO    ./texturs/wall2.xpm   
     EA    ./texturs/wall4.xpm

C       10,078,255

111111
10000N1
10000001
 111111